R 1000 1000

WE ./textures/stop.xpm
EA ./textures/door.xpm
SO ./textures/floor.xpm
NO ./textures/wall.xpm
S ./textures/pillar.xpm

F 50,200,200
C 0,0,0

111111111111111111111111
10000002000200000000011
10000000000000000000001
1000000N00000200000111
10000000000000000000111
10000000000000000000001
100000000000000000000001
11111111111111111111111