R 1550 1000

WE ./textures_bonus/wall1.xpm
EA ./textures_bonus/wall2.xpm
SO ./textures_bonus/wall3.xpm
NO ./textures_bonus/wall.xpm
S ./textures_bonus/sprite.xpm

F ./textures_bonus/floor.xpm
C ./textures_bonus/celling.xpm


       1111111111111111111111111111111111111111111
111111111100000000000000000000000000000001111
10000000000000000000000000000000000020000W1
1000222222222200000000000000011111111111111111111111
1000100000000001000000000111111111110000111
1000100000000001000000000111111111110000111
100010000000000100000000000000222222220000111
10001000222200001000000000000000001110000111
1000100000000001000000000000000000000000111
1000100000000000000000000000000000000000111
10002222222222222222222222000000000010000111
1000111111111111111111111111111111110000111
1000000000000000000000000000000000000000111
1000000000000000000000000000000000000000111
1111111111111111111111111111111111111111111